111111111111
10C0C0C0C0E1
1CCCCCCCCCC1
1C0CCCCCCCC1
1000000CCCP1
111111111111