11111111111111111111111111
10C0M001110M000100000000E1
100000000100C1001000000111
100100C00M1110000010M00001
100110100000111000000001C1
1P00011C11M0000011M1110001
100001CM000111000000110001
10011000000C000000M0001001
1001000M000111000000000001
1001100001100C000011M00001
10C0000000110000MC00000C01
1000011C0000C0000000011001
11111111111111111111111111