11111111111111111111111111
10C0001110000100000000E011
100000000100C1001000000111
100100C0011100000100000111
100110100000111000000001C1
1P00011C110000011111000001
100001C0001110000001100001
10011000000C00000000010001
10010000001110000000000011
1001100001100C000011000001
10C0000000110000C00000C011
1000011C0000C0000000011001
11111111111111111111111111
