11111111
10E01MP1
11010001
10000011
110001C1
10000001
11111111