111111111111111111111111111111111111111111
100000000P0CE00000000000000000000000000001
111111111111111111111111111111111111111111