1111111111
1PCE000001
10000001M1
1111111111