1111111
1E000C1
1000001
10000P1
1111111