111111111
100000001
100000001
10P0C00E1
100000001
100000001
111111111